1111111111111111111111111
100000000011000001000001111111
10110000011100000000000000000011
100100000000000000000000000000011
111111111011000000000000000000001
100000000011000001110111101111111
11110111111111011100000010001
111101111111110111010100100011
110000001101010111000000101001
100000000000000011000001100001
100000000000000011010111000001
11000001110101011101000000N0111
11110111 1110101 10111100000001
11111111 1111111 11111111111111
