NO img/BRICK_3D.png
SO img/BRICK_3B.png
WE img/BRICK_6D.png
EA img/motor.png
F  150, 30, 20
C  20, 70, 150

1111111111111111111111111
1000000000110000010000011111111
11010000011100000000000000000011
100100000000000000000000000000011
100111111011000000000000000000001
1001000000011000011110111101111111
11110111111111011100000010001   
 11101111111010111010100100011 111
110000001101010111000000101001 101
100000000000000011000000100001 111
100000000000000011010111000001
11000001110101011101000000N011111
11110111 111010000011110000000111
11111111 111111111111111111111111

